111111111111
100000000001
111101111111
111101111111
111101111111
111111111111
