11111111111111111
10000000111111111
100000000000W0001
11111111111111111
