NO ./img/wall_02.xpm
SO ./img/wall_03.xpm
WE ./img/purple.xpm
EA ./img/green.xpm

F 205,133,63
C 0,70,70

        1111111111111111111
        1000000000010000001
        1000010000010000011
111111111000010000010000011
100001000000000001111111111
1111111111111111111


11111111111111111111111111111
100001111100000001 1111111111            1
1000000000000N000010000000001           101
10000000000000000111111111111            1
1111111110111111111
        101
        101
        101
        101
        101
        101
        111




