F 83, 65, 31
C 000, 000, 000
NO ./img/collectible.xpm
SO ./img/wall.xpm
WE ./img/collectible.xpm
EA ./img/wall.xpm

1111111111111111111
1000000000010000011
1000010000010000011
1000010000010000011
1000010000000000011
1000011111000000011
100W000000000000011
1000000001000000011
1111111111111111111
