
NO ./textures/walls/Wall_01.xpm
        SO ./textures/walls/Wall_03.xpm
WE ./textures/walls/Wall_06.xpm
			EA ./textures/walls/Wall_09.xpm
C 50,50,200
F 50,50,50

        111111111111111
        100000000000001
        100000000000001111111111
        10000E000100000000000001
        100000000000001111111101
        100000000100001      101
        111111111111101      101
111111111111101111111101111111111
100000000000000000110000000000001
111111111011000001110000000000001
        1001000000000000000000001
        1111111111111111111111111

