11111111111111
10000000000001
10111111101111
101     101
111     111
