C  000, 000, 000
R  2147483647 2147483647
NO      ../Cub3D/img/floor.xpm
SO ../Cub3D/img/wall.xpm
EA ../Cub3D/img/exit.xpm
WE ../Cub3D/img/collectible.xpm

S ../Cub3D/img/wall.xpm
F 0,0,0

1111111111111111111
1000000000010000011
1000010000010000011
1000010000010000011
1000010000000000011
1000011111000000011
100N000000000000011
1000000001000000011
1111111111111111111
