111111111
10000000111111111
10000000000000001
11111111000001111
       1000001
       1111111
