11111111111
10N00000001
11111111111
