NO ./img/wall_02.xpm
SO ./img/wall_03.xpm
WE ./img/purple.xpm
EA ./img/green.xpm

C 70,70,70
F 205,133,63

1111111111111111111
1000000000010000011
1000010000010000011111111111111111
1000010000010000000000000000000001
1000010000000000011111111111111111
1000011111000000011
100N000000000000011
1000000001000000011
1111111111111111111