C  000, 000, 000
R  2147483647 2147483647
NO      ./textures/eagle.xpm
SO ./textures/greystone.xpm
EA ./textures/red.xpm
WE ./textures/purplestone.xpm

S ./textures/tonneau.xpm
F  255, 000, 255

11111111111111111
10000000111111111
1E000000000000001
11111111111111111
