NO ./img/wall_02.xpm
SO ./img/wall_03.xpm
WE ./img/purple.xpm
EA ./img/green.xpm

C 70,70,70
F 205,133,63

11111111111
10N00000001111111111111111111111111111111111111111111111111111111111111111111111111111111111111
10000000000000000000000000000000000000000000000000000000000000000000000000000000000000000000001
11111111111111111111111111111111111111111111111111111111111111101111111111111111111111111111111
                                                              101
                                                              101
                                                              101
                                                              101
                                                              101
                                                              101