11111111111111
10000000000E01
10111111101111
10111111101111
11111111111111
