F 191, 255, 255
C 000, 000, 000
NO ./img/wall.xpm
SO ./img/wall.xpm
WE ./img/wall.xpm
EA ./img/wall.xpm

11111111111111111
10000000111111111
1E000000000000001
11111111111111111
