N ./img/wall_02.xpm
S ./img/wall_03.xpm
W ./img/purple.xpm
E ./img/green.xpm

C 70,70,70
F 205,133,63














1111111111111111111
1000000000010000001
1000010000010000001
1000010000010000011
1000010000000000011
10000111110000000111111111111
10000000000000000000000000001
10000000010000000111111111111
111111111111111111

111111111111111111
100E0000010000000111111111111
111111111111111111