C  255,20 ,30
R  2147483647 2147483647
NO      ./textures/eagle.xpm
SO ./textures/greystone.xpm
EA ./textures/red.xpm
WE ./textures/purplestone.xpm

S ./textures/tonneau.xpm
F  000, 000, 00

11111111111111111
10000000111111111
100000000000W0001
11111111111111111
